TSLA = ("Tesla" OR "Tesla Inc" OR "Tesla stock" OR "Tesla shares" OR "Tesla electric vehicles")
NVDA = ("Nvidia" OR "NVIDIA Corporation" OR "Nvidia stock" OR "Nvidia shares" OR "Nvidia semiconductors")
AMD = ("Advanced Micro Devices" OR "AMD stock" OR "AMD shares" OR "AMD semiconductors")
COIN = ("Coinbase" OR "Coinbase Global" OR "Coinbase stock" OR "Coinbase cryptocurrency exchange")
PLTR = ("Palantir" OR "Palantir Technologies" OR "Palantir stock" OR "Palantir data analytics")
RIVN = ("Rivian" OR "Rivian Automotive" OR "Rivian stock" OR "Rivian electric vehicles")
SHOP = ("Shopify" OR "Shopify Inc" OR "Shopify stock" OR "Shopify e-commerce platform")
LCID = ("Lucid Motors" OR "Lucid Group" OR "Lucid stock" OR "Lucid electric vehicles")
ZM = ("Zoom Video Communications" OR "Zoom stock" OR "Zoom video conferencing")
SPCE = ("Virgin Galactic" OR "Virgin Galactic Holdings" OR "Virgin Galactic stock" OR "space tourism company")
KO = ("Coca-Cola" OR "Coca-Cola Company" OR "Coca-Cola stock" OR "Coca-Cola beverages")
PG = ("Procter & Gamble" OR "Procter and Gamble" OR "P&G stock" OR "consumer goods company")
JNJ = ("Johnson & Johnson" OR "Johnson and Johnson" OR "Johnson & Johnson stock" OR "healthcare company")
PEP = ("PepsiCo" OR "PepsiCo Inc" OR "PepsiCo stock" OR "Pepsi beverages")
WMT = ("Walmart" OR "Walmart Inc" OR "Walmart stock" OR "retail giant")
MCD = ("McDonald's" OR "McDonalds Corporation" OR "McDonald's stock" OR "fast food chain")
VZ = ("Verizon" OR "Verizon Communications" OR "Verizon stock" OR "telecommunications company")
DUK = ("Duke Energy" OR "Duke Energy Corporation" OR "utility company stock")
UL = ("Unilever" OR "Unilever PLC" OR "consumer goods multinational")
V = ("Visa" OR "Visa Inc" OR "Visa stock" OR "payment network company")
SPY = ("SPDR S&P 500 ETF" OR "SPDR S&P 500 ETF Trust" OR "SPY ETF" OR "S&P 500 ETF")
QQQ = ("Invesco QQQ ETF" OR "Invesco QQQ Trust" OR "Nasdaq 100 ETF" OR "QQQ ETF")
EEM = ("iShares MSCI Emerging Markets ETF" OR "Emerging Markets ETF" OR "EEM ETF")
VGK = ("Vanguard FTSE Europe ETF" OR "European equity ETF" OR "VGK ETF")
AGG = ("iShares Core U.S. Aggregate Bond ETF" OR "US bond market ETF" OR "AGG ETF")
VNQ = ("Vanguard Real Estate ETF" OR "US real estate ETF" OR "VNQ ETF")
ARKK = ("ARK Innovation ETF" OR "ARKK ETF" OR "disruptive technology ETF")
VUG = ("Vanguard Growth ETF" OR "US growth stocks ETF" OR "VUG ETF")
SCHD = ("Schwab US Dividend Equity ETF" OR "US dividend ETF" OR "SCHD ETF")
SOXX = ("iShares Semiconductor ETF" OR "semiconductor sector ETF" OR "SOXX ETF")
EURUSD = ("Euro to US dollar exchange rate" OR "EUR USD currency pair" OR "euro dollar forex")
USDJPY = ("US dollar to Japanese yen exchange rate" OR "USD JPY forex")
GBPUSD = ("British pound to US dollar exchange rate" OR "GBP USD forex")
USDCHF = ("US dollar to Swiss franc exchange rate" OR "USD CHF forex")
AUDUSD = ("Australian dollar to US dollar exchange rate" OR "AUD USD forex")
USDCAD = ("US dollar to Canadian dollar exchange rate" OR "USD CAD forex")
NZDUSD = ("New Zealand dollar to US dollar exchange rate" OR "NZD USD forex")
EURGBP = ("Euro to British pound exchange rate" OR "EUR GBP forex")
EURJPY = ("Euro to Japanese yen exchange rate" OR "EUR JPY forex")
GBPJPY = ("British pound to Japanese yen exchange rate" OR "GBP JPY forex")
BTC = ("Bitcoin" OR "Bitcoin cryptocurrency" OR "Bitcoin price" OR "Bitcoin market")
ETH = ("Ethereum" OR "Ethereum blockchain" OR "Ethereum cryptocurrency" OR "Ethereum price")
BNB = ("Binance Coin" OR "BNB cryptocurrency" OR "Binance ecosystem token")
XRP = ("Ripple" OR "XRP cryptocurrency" OR "Ripple blockchain")
SOL = ("Solana" OR "Solana blockchain" OR "Solana cryptocurrency")
TRX = ("TRON" OR "TRON blockchain" OR "TRX cryptocurrency")
DOGE = ("Dogecoin" OR "Dogecoin cryptocurrency" OR "Dogecoin meme coin")
ADA = ("Cardano" OR "Cardano blockchain" OR "ADA cryptocurrency")
AVAX = ("Avalanche blockchain" OR "Avalanche cryptocurrency" OR "AVAX token")
LTC = ("Litecoin" OR "Litecoin cryptocurrency" OR "Litecoin price")
GLD = ("Gold price" OR "Gold ETF" OR "SPDR Gold Shares")
SLV = ("Silver price" OR "Silver ETF" OR "iShares Silver Trust")
PPLT = ("Platinum price" OR "Platinum ETF")
PALL = ("Palladium price" OR "Palladium ETF")
USO = ("Crude oil price" OR "Oil ETF" OR "United States Oil Fund")
UNG = ("Natural gas price" OR "Natural gas ETF")
CORN = ("Corn price" OR "Corn ETF" OR "agricultural commodities")
SOYB = ("Soybean price" OR "Soybean ETF")
WEAT = ("Wheat price" OR "Wheat ETF")
CANE = ("Sugar price" OR "Sugar ETF")